r r h b b b p r h b
b r r r p r b r r r
p b r b p r b b b r
r r r b r b b p p r
h r r r r r r r r r
p r b r h r b r r b
r r b h r b r h r r
r p r r b r b b b r
b r p r b h b r r r
b r r r r r r r b p